11111
1...1
1...1
1...1
1...1
1.x.1
11111